200,200,200,200,200,200,200,200,200,200,200,200,200,200,200,200,200,200,200,200,200,200,200,200,200,200,200,200,200,200,200,200,200,200,200,200,200,200,200,0,0,0,0,0,0,0,0,0,0,0,0,0,0,0,0,0,0,0,0,0,-2
200,0,0,0,0,0,0,0,0,0,0,0,0,0,202,202,202,202,202,203,202,202,202,202,202,202,202,202,202,202,202,202,202,202,202,202,202,202,200,0,0,0,0,0,0,0,0,0,0,0,0,0,0,0,0,0,0,0,0,0,-2
200,0,-1,0,0,0,0,0,0,0,0,0,0,0,0,0,0,0,202,203,202,202,0,0,0,0,202,202,202,202,202,202,202,202,202,202,202,202,200,0,0,0,0,0,0,0,0,0,0,0,0,0,0,0,0,0,0,0,0,0,-2
200,0,102,0,0,0,0,220,220,0,0,0,0,0,0,0,0,0,0,203,202,0,0,0,0,0,0,0,0,0,202,202,202,202,202,202,202,202,200,0,0,0,0,0,0,0,0,0,0,0,0,0,0,0,0,0,0,0,0,0,-2
200,0,0,0,0,0,220,0,0,200,200,200,200,200,223,223,0,0,0,203,0,0,0,0,0,0,0,0,0,0,0,0,202,202,202,202,202,202,200,0,0,0,0,0,0,0,0,0,0,0,0,0,0,0,0,0,0,0,0,0,-2
200,0,0,0,0,220,220,0,0,200,202,0,0,203,203,203,0,0,0,0,0,0,212,212,212,212,212,212,212,0,0,0,202,202,202,202,202,202,200,0,0,0,0,0,0,0,0,0,0,0,0,0,0,0,0,0,0,0,0,0,-2
220,220,220,220,220,220,0,0,0,0,0,0,0,0,203,203,203,0,0,0,0,0,212,212,212,212,212,212,212,0,0,0,202,202,202,202,202,202,200,0,0,0,0,0,0,0,0,0,0,0,0,0,0,0,0,0,0,0,0,0,-2
200,202,202,0,0,0,0,0,0,0,0,0,0,0,0,0,203,0,6,0,0,0,212,212,212,212,212,212,233,0,0,0,0,202,202,202,202,202,200,0,0,0,0,0,0,0,0,0,0,0,0,0,0,0,0,0,0,0,0,0,-2
200,202,202,0,0,0,0,0,200,0,0,6,0,0,0,0,203,202,0,0,0,0,212,212,212,212,212,212,233,0,0,0,103,202,202,202,202,202,202,0,0,0,0,0,0,0,0,0,0,0,0,0,0,0,0,0,0,0,0,0,-2
200,0,0,0,0,0,0,0,102,0,0,0,0,3,0,0,203,202,202,202,0,0,212,212,212,212,212,212,212,0,0,0,0,202,202,202,202,202,202,0,0,0,0,0,0,0,0,0,0,0,0,0,0,0,0,0,0,0,0,0,-2
200,0,0,0,0,202,202,202,0,0,0,0,0,102,0,0,203,202,202,202,0,0,212,212,212,212,212,212,212,0,0,0,103,202,202,202,202,202,202,0,0,0,0,0,0,0,0,0,0,0,0,0,0,0,0,0,0,0,0,0,-2
200,0,0,0,202,202,0,0,0,0,0,0,0,102,0,0,203,203,203,203,203,203,203,203,203,203,203,203,203,0,0,0,0,202,202,202,202,202,200,0,0,0,0,0,0,0,0,0,0,0,0,0,0,0,0,0,0,0,0,0,-2
202,0,0,0,202,200,200,200,200,200,200,200,200,102,200,200,203,203,203,202,203,203,200,200,200,200,200,200,200,200,0,0,103,200,200,200,200,200,200,0,0,0,0,0,0,0,0,0,0,0,0,0,0,0,0,0,0,0,0,0,-2
202,0,0,0,0,0,0,201,201,0,0,0,0,0,0,0,0,0,0,202,0,0,0,112,0,0,0,0,0,0,0,0,202,202,0,0,0,0,202,0,0,0,0,0,0,0,0,0,0,0,0,0,0,0,0,0,0,0,0,0,-2
202,0,0,0,0,0,0,201,201,201,0,0,0,0,0,0,0,0,0,0,0,0,0,0,0,0,0,0,0,0,0,0,0,0,0,0,0,0,202,0,0,0,0,0,0,0,0,0,0,0,0,0,0,0,0,0,0,0,0,0,-2
202,203,0,0,0,0,203,201,201,0,0,0,201,0,0,0,0,6,100,0,202,0,122,0,0,112,0,0,0,0,0,0,0,0,0,0,0,0,202,0,0,0,0,0,0,0,0,0,0,0,0,0,0,0,0,0,0,0,0,0,-2
202,203,0,0,203,100,0,0,201,0,0,0,201,201,0,100,0,0,0,0,0,112,0,0,0,0,0,0,0,221,0,0,0,0,0,0,400,0,202,0,0,0,0,0,0,0,0,0,0,0,0,0,0,0,0,0,0,0,0,0,-2
202,203,0,0,0,0,0,0,0,0,0,201,201,201,0,0,0,0,0,0,0,0,0,0,112,0,0,0,221,221,221,0,0,0,0,0,103,0,202,0,0,0,0,0,0,0,0,0,0,0,0,0,0,0,0,0,0,0,0,0,-2
202,203,0,0,513,513,513,0,0,0,0,0,201,201,0,0,0,202,0,0,0,0,112,0,0,0,0,202,202,202,202,202,0,0,0,0,0,0,202,0,0,0,0,0,0,0,0,0,0,0,0,0,0,0,0,0,0,0,0,0,-2
202,202,202,202,202,202,202,202,202,202,202,202,202,202,202,202,202,202,202,202,202,202,202,202,202,202,202,202,202,202,202,202,202,202,202,202,202,202,202,0,0,0,0,0,0,0,0,0,0,0,0,0,0,0,0,0,0,0,0,0,-2
0,0,0,0,0,0,0,0,0,0,0,0,0,0,0,0,0,0,0,0,0,0,0,0,0,0,0,0,0,0,0,0,0,0,0,0,0,0,0,0,0,0,0,0,0,0,0,0,0,0,0,0,0,0,0,0,0,0,0,100,-2
0,0,0,0,0,0,0,0,0,0,0,0,0,0,0,0,0,0,0,0,0,0,0,0,0,0,0,0,0,0,0,0,0,0,0,0,0,0,0,0,0,0,0,0,0,0,0,0,0,0,0,0,0,0,0,0,0,0,0,100,-2
0,0,0,0,0,0,0,0,0,0,0,0,0,0,0,0,0,0,0,0,0,0,0,0,0,0,0,0,0,0,0,0,0,0,0,0,0,0,0,0,0,0,0,0,0,0,0,0,0,0,0,0,0,0,0,0,0,0,0,100,-2
0,0,0,0,0,0,0,0,0,0,0,0,0,0,0,0,0,0,0,0,0,0,0,0,0,0,0,0,0,0,0,0,0,0,0,0,0,0,0,0,0,0,0,0,0,0,0,0,0,0,0,0,0,0,0,0,0,0,0,100,-2
0,0,0,0,0,0,0,0,0,0,0,0,0,0,0,0,0,0,0,0,0,0,0,0,0,0,0,0,0,0,0,0,0,0,0,0,0,0,0,0,0,0,0,0,0,0,0,0,0,0,0,0,0,0,0,0,0,0,0,100,-2
100,0,0,0,0,0,0,0,0,0,0,0,0,0,0,0,0,0,0,0,0,0,0,0,0,0,0,0,0,0,0,0,0,0,0,0,0,0,0,0,0,0,0,0,0,0,0,0,0,0,0,0,0,0,0,0,0,0,0,100,-2
100,0,0,0,0,0,0,0,0,0,0,0,0,0,0,0,0,0,0,0,0,0,0,0,0,0,0,0,0,0,0,0,0,0,0,0,0,0,0,0,0,0,0,0,0,0,0,0,0,0,0,0,0,0,0,0,0,0,0,100,-2
100,0,0,0,0,0,0,0,0,0,0,0,0,0,0,0,0,0,0,0,0,0,0,0,0,0,0,0,0,0,0,0,0,0,0,0,0,0,0,0,0,0,0,0,0,0,0,0,0,0,0,0,0,0,0,0,0,0,0,100,-2
100,0,0,0,0,0,0,0,0,0,0,0,0,0,0,0,0,0,0,0,0,0,0,0,0,0,0,0,0,0,0,0,0,0,0,0,0,0,0,0,0,0,0,0,0,0,0,0,0,0,0,0,0,0,0,0,0,0,0,100,-2
100,100,100,100,100,100,100,100,100,100,100,100,100,100,100,100,100,100,100,100,100,100,100,100,100,100,100,100,100,100,100,100,100,100,100,100,100,100,100,100,100,100,100,100,100,100,100,100,100,100,100,100,100,100,100,100,100,100,100,100,-2
